AA	ɑː
AE	æ
AH	ʌ
AO	ɔ
AW	aʊ
AY	aɪ
B	b
CH	tʃ
D	d
DH	ð
EH	ɛ
ER	əɹ
EY	eɪ
F	f
G	g
HH	h
IH	ɪ
IY	iː
JH	dʒ
K	k
L	l
M	m
N	n
NG	ŋ
OW	oʊ
OY	ɔɪ
P	p
R	ɹ
S	s
SH	ʃ
T	t
TH	θ
UH	ʊ
UW	uː
V	v
W	w
WH	ʍ
Y	j
Z	z
ZH	ʒ
